-30,17,800 -13,30,1000 -13,34,2200 -28,24,2200  0
-23,27,3000 -30,23,1500 -34,31,3000 -30,27,200  0
-28,20,2600 -23,29,1400 -24,22,2100 -19,16,300  0
-13,13,2800 -19,19,1500 -18,33,700 -29,35,1900  0
-23,28,1600 -29,11,1700 -32,11,2700 -29,19,2100  15380
-34,23,1700 -35,13,2200 -12,13,2200 -20,26,1100  34550
-13,17,1800 -27,34,2400 -29,11,2300 -23,14,1000  14610
-34,10,2500 -17,28,100 -35,10,2900 -15,17,3000  0
-25,33,700 -19,24,2500 -26,26,2900 -29,17,1300  0
-21,10,3000 -16,33,2000 -19,24,2300 -24,17,2600  0
-17,28,300 -15,13,1200 -23,31,2300 -17,13,1600  0
-19,35,2700 -32,31,500 -28,31,1900 -12,31,1400  0
-14,21,1700 -17,24,1100 -32,16,1200 -20,24,200  0
-17,18,1600 -30,35,100 -33,35,1000 -12,10,400  0
-32,26,1900 -18,35,3000 -17,14,1900 -29,23,900  0
-35,25,1600 -31,23,1900 -25,10,2700 -29,32,2000  25000
-22,33,1200 -15,11,1200 -21,28,1600 -12,14,2500  0
-14,12,2900 -12,25,1300 -20,28,2100 -18,30,1000  0
-24,32,500 -31,21,600 -35,10,500 -24,31,2600  24970
-24,17,900 -28,25,2700 -26,19,2700 -24,29,700  0
-26,18,2900 -30,31,2800 -15,30,2300 -26,11,300  0
-28,18,1500 -18,30,2400 -19,33,2600 -23,12,2600  0
-22,23,700 -15,34,800 -12,12,1100 -28,23,1600  0
-11,30,1600 -28,28,2500 -19,28,1400 -23,13,900  0
-23,22,2100 -19,22,2600 -24,26,700 -30,29,2200  0
-20,32,100 -19,32,700 -12,20,1000 -29,20,1800  0
-32,26,500 -10,27,2800 -27,23,2500 -23,13,2300  0
-30,25,3000 -35,34,600 -35,17,900 -22,31,2000  0
-16,16,1600 -18,19,1200 -10,35,800 -34,13,3000  0
-32,28,2300 -32,11,300 -10,10,1100 -19,14,500  0
