-35,25,100 -37,14,100 -12,14,163 -21,25,100  34890
-28,28,100 -32,15,103 -22,11,100 -22,25,200  0
-22,34,199 -31,15,100 -33,10,100 -25,24,100  0
-22,29,100 -30,18,165 -34,11,135 -28,26,120  0
-22,30,100 -30,24,162 -41,12,100 -26,32,226  0
-25,29,100 -32,13,100 -28,12,100 -31,19,100  0
