-35,22,125 -35,15,100 -12,13,100 -19,26,100  34210
-25,26,100 -28,10,100 -31,10,100 -31,18,100  15630
-34,24,1650 -33,18,2050 -18,11,2450 -24,29,1550  0
-37,27,206 -31,21,100 -23,10,189 -31,32,100  0
-23,30,1050 -30,16,1150 -33,10,1600 -26,25,2350  0
-23,31,152 -32,23,100 -37,12,100 -26,32,100  0
-21,17,1300 -20,32,1700 -21,22,2250 -25,19,1600  0
-11,18,100 -28,35,100 -31,10,100 -24,16,100  0
-28,16,100 -15,31,100 -13,32,140 -29,26,100  0
-25,23,2800 -26,26,1450 -29,26,2550 -24,21,250  0
-21,26,100 -30,23,100 -33,32,137 -31,26,100  0
-30,22,100 -22,29,103 -26,20,100 -20,18,100  0
-23,11,2650 -18,23,800 -26,21,1800 -22,26,2450  0
-14,11,111 -18,17,100 -20,33,195 -29,34,100  0
-32,12,205 -15,30,100 -34,10,183 -16,15,100  0
-23,21,1850 -17,28,2250 -22,25,2600 -26,17,1950  0
-25,32,100 -18,24,100 -26,28,100 -27,17,100  0
-21,10,172 -17,35,100 -17,25,100 -25,15,100  0
-18,31,1500 -23,22,850 -25,31,2100 -14,22,1500  0
-17,26,100 -13,13,100 -25,33,132 -15,14,127  0
-19,35,100 -32,31,155 -30,29,131 -11,30,117  0
-15,19,1650 -23,29,600 -32,25,1100 -16,17,300  0
-15,23,100 -15,22,100 -30,15,100 -20,23,222  0
-19,20,100 -32,33,218 -31,34,100 -13,11,100  0
