-34,24,100 -35,15,100 -12,13,100 -20,27,207  35890
-22,32,100 -29,15,107 -32,10,100 -25,24,193  25020
-22,30,100 -30,25,199 -39,12,111 -25,34,141  24260
-23,28,100 -30,11,132 -30,10,159 -32,18,100  15220
-30,24,112 -31,12,100 -21,11,100 -25,22,100  0
-35,25,928 -32,19,1075 -20,10,1319 -27,30,825  0
-33,25,100 -35,20,100 -20,10,185 -22,30,149  0
-37,26,222 -31,22,100 -25,12,100 -32,32,216  0
-23,30,601 -31,19,625 -35,11,850 -26,28,1225  0
-16,17,700 -24,33,900 -26,16,1175 -24,17,850  0
-20,16,180 -22,33,100 -20,21,100 -24,18,100  0
-11,16,100 -26,36,100 -29,10,118 -25,18,100  0
