-21,21,1000 -23,17,825 -21,21,875 -17,23,650  0
-28,16,151 -28,12,100 -22,25,100 -11,17,100  0
-15,28,100 -17,22,100 -19,16,180 -22,30,171  0
-26,22,1550 -23,20,1300 -24,18,1525 -21,22,800  0
-31,20,127 -21,28,100 -23,19,100 -31,21,100  0
-24,24,100 -23,14,100 -23,18,100 -13,25,141  0
-24,21,1000 -25,26,1050 -26,19,999 -25,23,1135  29050
-24,24,100 -24,22,100 -27,18,100 -27,30,149  0
-24,19,100 -27,27,100 -25,19,100 -25,19,100  32370
-33,19,850 -19,21,1400 -24,21,375 -24,24,700  0
-37,26,100 -14,24,100 -23,13,100 -34,22,100  0
-28,15,100 -23,18,100 -25,29,100 -14,27,100  0
-29,15,107 -25,18,142 -26,28,100 -15,26,103  0
-28,21,100 -22,10,141 -30,22,100 -11,24,100  34800
-26,12,100 -33,29,100 -21,34,100 -19,32,100  0
-27,27,100 -26,23,100 -27,19,100 -25,30,103  0
-35,32,100 -36,32,100 -33,22,100 -27,25,114  0
-18,22,125 -16,16,100 -22,17,103 -23,33,100  0
