-20,20,168 -30,17,100 -34,18,100 -13,21,100  83430
-24,19,100 -21,25,100 -25,21,100 -17,20,100  80550
-35,27,100 -16,36,100 -18,20,100 -16,29,100  75060
-25,17,151 -29,11,100 -36,21,100 -15,30,158  73490
-28,23,1000 -23,27,1038 -24,18,1200 -15,24,1302  65660
-24,24,100 -20,19,100 -10,24,100 -37,10,100  62820
-22,16,100 -16,14,178 -14,15,100 -18,10,100  57680
-28,22,700 -18,22,652 -18,29,908 -25,15,1200  0
-33,26,180 -17,30,100 -20,38,149 -26,15,114  0
-24,18,100 -21,18,100 -17,22,135 -27,17,100  0
-22,18,125 -21,13,182 -24,17,137 -17,19,110  0
-20,30,100 -31,21,100 -29,32,162 -23,15,100  0
-14,34,100 -26,13,100 -34,29,217 -19,12,100  0
-28,28,100 -37,26,201 -26,37,100 -24,16,100  0
-28,21,158 -25,20,100 -11,26,100 -29,10,100  0
-29,15,100 -34,19,100 -13,27,210 -25,12,100  0
-18,20,2150 -25,25,1450 -26,25,1900 -20,17,1325  0
-11,20,146 -25,29,105 -29,26,100 -23,15,100  0
