-32,26,100 -15,29,105 -18,37,166 -24,16,100  82520
-24,19,1300 -21,16,1200 -18,21,1650 -27,15,2300  80550
-22,20,1900 -30,19,1850 -32,16,2300 -14,19,2450  77170
-34,27,100 -17,35,227 -17,20,100 -16,30,154  72390
-21,18,100 -16,16,153 -13,14,174 -18,10,100  64700
-24,18,150 -27,10,211 -35,20,100 -17,29,121  59110
-14,32,100 -27,14,100 -32,29,224 -20,14,100  57390
-26,28,100 -35,28,100 -26,35,100 -26,16,100  56470
-31,16,100 -32,21,100 -11,28,100 -24,10,100  54590
-25,26,217 -18,19,100 -11,25,100 -35,10,100  52880
-11,21,2500 -27,27,550 -29,28,1550 -25,16,1050  51610
-26,20,1800 -23,24,2350 -23,23,2250 -16,19,1600  0
-32,28,136 -32,15,117 -19,20,100 -16,17,100  0
-21,13,100 -14,33,206 -27,29,100 -16,19,100  0
-23,24,950 -30,21,1000 -23,23,2850 -27,14,2150  0
-33,15,100 -34,26,107 -14,14,100 -35,12,100  0
-22,24,100 -32,28,100 -30,12,100 -13,10,100  0
-26,21,1550 -16,23,2500 -16,23,1650 -21,12,1850  0
-28,21,1800 -33,24,2450 -17,30,1900 -25,13,500  0
-19,23,1650 -22,33,1750 -32,27,2050 -35,21,700  0
-12,33,100 -28,32,158 -30,27,165 -34,10,100  0
-25,11,188 -18,37,100 -34,26,159 -37,33,100  0
-18,17,2250 -19,32,1200 -25,18,1100 -18,24,1950  0
-20,22,102 -15,33,100 -27,23,100 -26,29,139  0
-17,14,100 -25,32,100 -23,12,100 -10,15,100  0
-25,13,185 -20,10,100 -25,15,100 -20,21,100  0
-17,25,1500 -21,22,700 -31,22,1100 -24,34,1800  0
-22,37,100 -20,33,100 -32,30,177 -18,35,100  0
-13,15,100 -23,11,100 -34,13,100 -33,34,100  0
-21,22,1250 -23,11,1550 -25,17,550 -32,33,1200  0
-16,17,100 -23,10,100 -32,14,202 -33,36,100  0
-27,30,100 -28,10,100 -18,19,127 -34,34,100  0
-21,22,1250 -23,11,1550 -25,17,550 -32,33,1200  0
-27,28,100 -25,12,100 -17,19,100 -32,33,163  0
-12,14,213 -23,13,100 -32,15,100 -31,35,100  0
-18,14,1750 -27,11,1700 -27,13,2000 -24,31,1700  0
-15,18,100 -19,10,100 -33,14,174 -31,33,134  0
-21,14,100 -33,10,100 -23,14,100 -17,29,212  0
-28,19,1550 -26,22,2100 -20,16,2850 -17,29,2500  0
-21,15,100 -35,10,100 -19,12,122 -16,28,100  0
-36,25,142 -21,35,191 -18,19,100 -17,28,122  0
-23,27,1950 -27,27,1250 -23,26,1900 -19,20,1900  0
-12,27,100 -33,22,100 -30,32,230 -20,10,100  0
-12,31,100 -37,21,100 -27,36,118 -20,10,100  0
-10,16,100 -18,34,100 -33,24,100 -32,24,100  0
