-33,29,1200 -34,17,3000 -18,19,2000 -15,19,700  77750
-19,12,2400 -13,31,1700 -29,27,2500 -17,19,2500  73410
-14,33,900 -29,16,900 -31,30,3000 -20,16,1900  71420
-33,15,1000 -32,27,1100 -15,16,2700 -35,13,2400  65640
-20,23,2800 -33,27,2400 -31,11,2500 -11,10,2000  64460
-24,17,1000 -27,11,1300 -34,21,2100 -18,29,2900  59800
-22,16,1100 -17,17,2200 -14,12,2500 -20,11,1800  59250
-31,26,2000 -15,30,2800 -18,35,800 -23,14,1900  57740
-30,17,2600 -33,21,3000 -10,27,2000 -26,10,400  54090
-26,26,1000 -34,27,1900 -24,33,1800 -24,16,600  53700
-13,34,700 -26,31,2200 -31,26,2500 -35,10,500  49690
-25,12,2600 -18,35,1300 -33,28,1600 -35,33,900  0
-18,21,2500 -15,35,600 -28,25,1700 -25,31,1600  0
-19,14,2000 -23,30,1800 -23,11,500 -12,17,2300  0
-25,15,300 -22,12,2000 -27,17,2100 -20,20,1700  0
-23,24,2300 -20,20,400 -10,25,1200 -34,11,2900  0
-16,21,1500 -26,17,2600 -18,15,500 -13,20,1200  0
-33,20,2300 -27,30,2700 -30,25,1800 -25,13,2700  0
-11,18,1300 -33,28,1200 -12,28,2400 -21,12,1700  0
-17,28,1300 -16,24,2500 -26,34,900 -28,12,1000  0
-22,25,2200 -27,13,3000 -20,10,2900 -10,19,2000  0
-15,18,1800 -20,22,2200 -23,22,2100 -12,17,500  0
-12,13,2500 -12,17,2200 -30,26,2400 -18,19,500  0
-19,32,1900 -33,12,1300 -23,31,300 -23,25,100  0
-10,35,2500 -26,14,2200 -21,33,300 -27,30,800  0
-15,10,1500 -23,35,900 -26,35,1100 -27,21,100  0
-22,23,300 -29,24,1100 -32,20,1500 -10,26,900  0
-22,13,1600 -34,11,2400 -21,14,3000 -17,29,2800  0
-16,17,2300 -17,23,100 -35,13,1000 -26,24,500  0
-21,31,2800 -25,17,600 -16,22,2700 -17,30,900  0
-23,33,1900 -24,34,2500 -11,35,1800 -28,25,1200  0
-34,20,300 -34,16,1800 -29,24,3000 -18,20,2000  0
-14,16,1900 -21,11,1000 -33,13,1000 -31,34,600  0
-10,14,2600 -19,34,400 -31,23,2000 -30,22,500  0
-10,14,2900 -21,23,2800 -21,20,300 -23,21,1700  0
-12,29,2400 -35,21,700 -28,34,1100 -21,11,1600  0
-29,22,800 -25,25,900 -28,19,1900 -12,15,300  0
-28,28,600 -26,11,2100 -18,21,100 -33,32,1800  0
-27,11,1000 -32,25,600 -11,12,2000 -33,35,900  0
-21,35,1100 -21,34,400 -30,32,1200 -17,34,3000  0
-35,25,1500 -19,33,1800 -19,18,2700 -18,30,2200  0
-29,21,800 -27,28,1700 -12,26,2200 -28,18,2900  0
-28,19,700 -21,27,2200 -19,19,1400 -11,25,1900  0
-20,18,2600 -16,21,2800 -28,16,1200 -15,33,1600  0
-25,30,2300 -17,24,2500 -34,33,3000 -16,28,1400  0
-21,17,2600 -28,14,1500 -15,12,2000 -16,19,600  0
-13,26,700 -32,29,1100 -15,35,300 -19,33,800  0
-32,19,3000 -10,35,2500 -20,33,500 -24,24,2000  0
-35,31,2200 -35,16,2700 -26,26,1700 -20,28,2000  0
-26,34,2400 -31,20,2000 -26,11,1200 -16,29,2800  0
