-25,19,141 -16,16,100 -24,16,114 -33,34,224  58480
-29,29,180 -14,13,100 -33,24,147 -32,31,100  56770
-33,23,100 -30,15,100 -15,16,100 -18,32,100  56570
-32,32,100 -35,22,115 -10,22,175 -21,25,142  55630
-17,17,202 -10,24,100 -25,22,100 -18,13,100  47560
-34,33,196 -27,23,123 -18,15,100 -25,33,100  47430
-30,22,2200 -27,25,100 -20,14,2150 -27,29,2400  46680
-14,30,100 -13,34,100 -20,10,100 -13,29,221  45830
-35,33,100 -32,13,100 -26,33,100 -14,21,100  45040
-14,10,100 -25,25,100 -24,17,100 -19,31,211  44360
-34,33,100 -22,31,100 -32,27,100 -22,34,100  38120
-17,28,750 -18,27,2350 -27,19,1700 -13,25,1400  37340
-13,18,100 -14,26,168 -24,23,100 -16,16,100  36640
-28,33,100 -29,35,100 -32,28,100 -14,34,160  28600
-26,23,1750 -14,14,2000 -29,19,2250 -30,32,1500  27560
-25,12,100 -29,27,100 -20,14,100 -31,28,164  0
-21,24,156 -24,25,100 -34,27,100 -12,20,100  0
-24,18,500 -18,18,1350 -23,31,150 -28,10,1550  0
-37,18,100 -25,26,146 -32,29,100 -24,11,100  0
-15,18,100 -10,11,100 -14,29,100 -33,13,100  0
-28,25,1850 -23,29,1800 -22,30,1200 -20,25,900  0
-25,20,100 -20,27,100 -17,34,110 -27,19,100  0
-27,11,350 -22,12,1600 -14,27,800 -22,27,1150  0
-33,10,100 -15,13,100 -11,22,168 -15,21,100  0
-25,13,164 -26,11,100 -16,36,127 -29,33,100  0
-12,17,1600 -19,29,2350 -24,20,1500 -22,31,1950  0
-12,25,215 -14,36,100 -23,24,120 -24,31,100  0
-29,23,1300 -32,20,1800 -17,20,1750 -23,23,1800  0
-22,14,100 -29,19,100 -21,18,193 -24,24,100  0
-21,19,1800 -19,29,2150 -25,21,1450 -24,16,2450  0
-27,21,102 -28,37,100 -24,20,100 -32,17,100  0
-25,20,2250 -21,19,1550 -19,18,500 -16,24,1950  0
-35,23,100 -31,16,100 -15,17,100 -16,31,144  0
-35,23,1600 -30,15,900 -14,15,300 -17,33,1700  0
-33,21,201 -31,13,100 -15,16,119 -17,33,100  0
-36,22,100 -31,17,100 -15,17,100 -15,33,100  0
-28,18,1900 -25,22,1050 -13,16,1450 -15,24,1800  0
-20,13,100 -21,28,198 -10,16,100 -12,14,120  0
-28,24,2350 -20,30,950 -21,23,2600 -18,25,1800  0
-21,14,192 -20,28,100 -13,16,100 -13,15,100  0
-32,37,130 -18,31,201 -30,27,100 -24,34,222  0
-34,33,1650 -26,21,850 -27,31,2050 -19,27,1650  0
-34,32,100 -34,10,100 -23,35,100 -14,21,100  0
-27,32,1550 -23,17,750 -19,24,1800 -17,21,1800  0
-22,33,230 -11,24,100 -14,14,100 -20,21,157  0
