-23,13,200 -27,13,2800 -18,35,700 -31,33,400  0
-11,24,2200 -15,34,2600 -22,23,1700 -26,31,1100  0
-14,11,1000 -23,25,2100 -26,18,1300 -19,31,2800  0
-24,14,700 -31,20,2000 -23,19,2300 -24,23,1200  0
-34,32,1900 -34,21,1600 -11,21,1200 -22,23,2400  0
-27,11,1500 -28,29,100 -20,15,2300 -31,26,2000  46480
-35,17,800 -25,25,2400 -34,31,100 -25,10,2300  44360
-25,28,500 -28,27,2900 -10,20,900 -27,35,2800  0
-30,15,1500 -14,19,2900 -18,29,1900 -24,29,2400  0
-19,23,1600 -21,30,2000 -11,10,2500 -24,13,2800  0
-21,25,700 -32,10,1800 -21,28,3000 -28,15,2700  0
-33,33,2900 -26,21,100 -20,14,2000 -23,32,2800  57120
-28,28,1900 -13,13,1300 -35,24,2400 -30,30,2300  57810
-27,12,700 -28,25,1900 -25,13,2100 -25,32,2600  0
-15,18,2900 -12,24,2200 -25,22,700 -16,15,2200  0
-29,21,300 -32,19,1800 -20,11,2700 -25,31,2700  0
-33,21,1700 -20,32,1400 -35,23,1700 -35,16,1300  0
-22,14,2200 -21,30,1200 -12,18,2600 -13,15,1900  0
-13,31,400 -13,32,2700 -22,12,2700 -15,31,900  44800
-35,32,800 -33,11,1000 -25,35,1500 -14,19,1600  0
-32,26,1800 -34,21,3000 -16,33,1800 -24,35,200  0
-13,19,200 -12,12,300 -13,31,200 -32,11,800  37780
-14,21,2000 -23,11,2700 -28,15,1600 -14,11,1800  0
-18,35,1600 -17,12,2100 -25,14,1600 -32,10,600  0
-26,19,2500 -19,25,1800 -15,34,100 -29,17,500  34040
-21,28,2100 -21,12,100 -31,13,3000 -14,12,900  0
-25,27,900 -20,22,2700 -14,21,1800 -31,27,2000  0
-15,16,1900 -19,30,2700 -18,33,300 -20,23,2300  0
-31,10,500 -17,12,400 -11,20,900 -14,21,1900  27150
-13,32,2800 -33,13,2000 -14,10,2600 -28,17,1700  0
-18,11,1700 -17,33,200 -18,21,2800 -15,24,1100  0
-30,32,1200 -28,33,1800 -30,26,2300 -12,34,1300  28030
-31,11,2400 -27,21,2900 -25,10,2400 -33,22,1100  0
-20,32,2300 -13,24,500 -14,14,2100 -20,23,2000  0
-25,19,1600 -16,15,2700 -24,14,2100 -31,35,700  58480
-16,22,2300 -22,30,1000 -12,14,200 -30,33,2400  0
-27,13,3000 -29,21,1100 -12,23,2300 -28,18,2600  0
-13,30,300 -29,18,1300 -30,32,2900 -27,26,2100  0
-21,25,1100 -24,23,2000 -33,26,700 -12,20,1900  46310
-16,18,600 -26,28,1000 -14,33,1200 -17,29,1600  0
-35,23,1600 -30,15,900 -14,15,300 -17,33,1700  0
-12,24,2900 -21,27,2000 -14,26,2500 -15,28,2900  0
-34,35,2500 -20,31,700 -30,28,2600 -24,35,1700  0
-27,20,700 -27,35,2100 -25,20,2200 -32,18,2700  0
-35,25,2900 -12,19,2800 -15,13,2100 -14,20,1200  0
-13,12,1400 -21,33,200 -12,25,1300 -15,33,1200  0
-13,35,3000 -12,22,600 -23,12,1500 -30,25,2400  0
-14,28,1600 -35,18,1600 -34,27,1000 -18,35,1400  0
-35,24,2500 -12,32,2000 -15,24,2000 -27,35,200  0
-33,17,500 -35,20,1600 -20,16,2300 -14,26,200  0
 55940
