-18,1,1800 -25,31,900 -7,28,1500 -15,13,700  22540
-21,15,1100 -34,30,600 -31,35,500 -19,23,700  0
-25,24,1200 -32,3,2700 -5,9,900 -26,30,2800  0
-28,20,2400 -32,14,2000 -29,6,2500 -31,14,2900  0
-5,14,2200 -31,34,2400 -23,28,1500 -3,14,300  0
-35,11,600 -20,30,1300 -22,28,1400 -16,1,2600  0
