-29,17,100 -29,14,100 -24,26,100 -12,16,100  39130
-13,26,1900 -18,21,1550 -19,17,1650 -22,30,1200  36410
-30,21,2050 -22,26,750 -23,18,1650 -30,19,250  34800
-22,23,1050 -25,15,1850 -25,18,1400 -12,26,1350  32730
-26,25,1900 -24,24,2000 -27,19,1850 -25,28,2100  28830
-23,18,100 -26,29,100 -25,20,149 -25,18,170  0
-36,25,100 -15,26,100 -23,15,100 -34,23,100  0
-30,14,1600 -24,17,2700 -25,28,650 -15,25,1300  0
-30,19,100 -20,10,185 -32,23,100 -11,22,106  0
-28,12,114 -31,27,100 -20,33,100 -19,31,100  0
-34,32,100 -35,31,100 -33,23,100 -26,26,100  0
-20,22,100 -17,16,100 -22,16,100 -25,34,106  0
-28,24,1400 -22,18,2150 -22,25,950 -19,21,750  0
-24,35,100 -24,18,135 -11,14,100 -27,27,100  0
-31,15,177 -18,16,100 -32,34,100 -10,14,100  0
-18,28,2550 -16,14,2050 -22,10,900 -24,27,1500  0
-13,27,100 -19,10,100 -13,10,100 -23,27,100  0
-24,31,100 -12,14,138 -34,13,100 -28,29,100  0
-30,17,2150 -21,30,1150 -25,22,450 -23,14,1600  0
-32,14,100 -17,28,100 -30,20,100 -11,13,100  0
-27,23,201 -28,32,166 -22,24,100 -36,19,100  0
-21,21,1750 -16,30,1750 -22,16,950 -22,20,1250  0
-28,10,137 -11,25,199 -23,20,100 -17,13,117  0
-13,32,100 -23,33,100 -20,11,100 -29,27,100 -30,23,1200 -29,30,450 -35,17,1700 -21,33,1450  0
 0
-29,13,198 -31,28,111 -35,10,100 -14,31,100  0
-32,29,100 -28,34,105 -36,24,100 -30,36,179  0
-22,12,1350 -23,16,2000 -20,24,1650 -28,16,400  0
-19,10,100 -13,10,100 -13,15,100 -31,21,100  0
-27,13,100 -37,21,160 -31,35,100 -25,11,142  0
-23,12,1300 -24,24,2150 -21,26,550 -30,14,450  0
-28,11,115 -33,24,100 -32,34,101 -26,11,100  0
-18,11,100 -13,26,110 -14,20,100 -35,14,100  0
-19,21,2100 -18,27,2100 -16,25,1350 -32,19,1600  0
-19,13,100 -11,25,100 -12,20,160 -35,14,100  0
-19,32,100 -24,25,100 -20,31,100 -31,24,100  0
-23,25,1700 -27,19,2250 -23,28,2000 -20,20,2550  0
-19,30,231 -26,28,100 -23,34,100 -30,25,100  0
-27,21,100 -31,11,127 -25,25,100 -11,18,100  0
-29,19,400 -31,12,2900 -26,24,1700 -11,18,2300  0
-30,19,100 -33,10,125 -25,23,100 -10,16,150  0
-30,21,135 -33,14,100 -28,24,100 -13,17,100  0
-13,27,101 -17,18,100 -24,11,100 -16,36,100  0
-16,28,142 -21,18,100 -24,12,100 -16,37,100  0
-13,24,100 -17,23,100 -15,21,100 -30,23,100  0
