-31,18,2000 -19,10,2400 -31,21,700 -12,21,700  0
-29,10,1200 -30,25,3000 -19,35,600 -18,30,1900  0
-35,25,2200 -17,25,1000 -23,15,1400 -34,21,400  29540
-33,30,1900 -33,31,2400 -35,21,1400 -24,25,2300  0
-19,21,1900 -16,18,1600 -20,18,2300 -27,32,1900  0
-26,34,1900 -24,19,2300 -12,16,1200 -28,29,200  0
-30,15,900 -20,17,2000 -33,34,700 -11,14,1300  0
-11,26,2100 -21,12,2100 -13,10,1000 -22,27,1800  0
-25,31,3000 -12,16,2000 -32,11,800 -27,27,1200  0
-32,14,1900 -16,27,1500 -31,19,100 -13,12,200  0
-28,21,2400 -27,33,800 -20,26,800 -34,17,3000  0
-25,17,1900 -27,28,500 -24,22,1900 -27,18,100  37920
-30,11,1800 -10,26,2600 -23,20,1800 -16,15,1000  0
-13,31,1700 -23,35,900 -21,12,100 -28,26,1500  0
-27,15,100 -33,28,200 -35,11,2100 -14,32,300  0
-34,31,2300 -26,32,700 -35,23,1300 -29,35,2600  0
-29,35,2500 -17,24,2300 -28,23,2900 -18,21,2400  0
-33,22,2200 -15,20,400 -12,24,2500 -32,31,2100  0
-20,11,1200 -13,27,2600 -12,19,400 -35,16,400  0
-27,26,700 -14,27,900 -29,13,1300 -15,23,1800  0
-12,32,2800 -15,35,1700 -24,17,2300 -29,32,900  0
-19,21,2800 -10,32,2700 -30,25,2000 -16,22,2500  0
-25,18,1600 -24,16,2600 -34,10,2500 -35,13,500  0
-10,33,300 -34,14,1200 -11,26,1200 -35,19,3000  0
-15,27,1700 -19,19,800 -24,12,1100 -14,35,400  0
-22,14,2800 -19,13,1100 -18,31,1600 -28,34,1400  0
-18,32,3000 -24,27,1600 -21,32,2300 -30,23,2800  0
-27,16,700 -18,15,1700 -24,16,100 -18,22,1800  0
-18,26,1300 -26,29,1700 -24,25,3000 -13,26,400  0
-31,24,1000 -21,22,1800 -19,11,400 -22,29,1300  0
-26,13,1400 -35,22,1700 -30,34,700 -25,13,500  0
-12,25,2100 -18,24,2300 -15,23,2200 -30,25,2000  0
-14,12,2300 -31,15,1900 -23,25,100 -31,11,2700  0
-18,20,2400 -30,30,2600 -10,20,1500 -26,15,2600  0
-19,12,1300 -11,10,2300 -11,14,2600 -31,19,300  0
-30,24,500 -30,14,1200 -13,11,2700 -21,13,100  0
-15,33,2700 -14,20,1600 -25,35,1500 -28,24,1000  0
-16,27,600 -28,29,900 -22,29,100 -22,11,2200  0
-15,32,2900 -27,13,1000 -25,13,800 -13,20,200  0
-18,21,1800 -35,19,1200 -28,27,1400 -14,34,2000  0
-12,30,2300 -24,31,2200 -21,23,800 -14,24,700  0
-14,18,3000 -19,33,2600 -26,16,1700 -18,26,800  0
-14,34,800 -34,21,3000 -16,10,2100 -10,23,1400  0
-24,25,2500 -14,18,700 -16,27,200 -13,17,2600  0
-29,33,1400 -31,17,1900 -27,23,2000 -24,29,1400  0
-29,22,2300 -32,34,200 -26,19,1200 -28,16,2700  0
-10,17,800 -16,26,2100 -14,18,1500 -16,15,2500  0
-23,30,2000 -26,29,100 -17,33,500 -19,34,800  0
-29,19,400 -31,12,2900 -26,24,1700 -11,18,2300  0
-28,17,1800 -10,35,2900 -30,31,400 -21,30,100  0
