-35,18,1800 -19,11,1150 -23,22,1700 -16,27,1050  45670
-33,18,100 -24,10,100 -31,34,100 -10,23,100  27970
-35,17,113 -16,11,100 -13,11,150 -24,29,139  0
-20,17,1800 -19,15,900 -14,23,1500 -18,27,1300  0
-25,15,108 -24,12,100 -16,24,188 -24,30,100  0
-13,19,100 -14,17,100 -11,24,100 -10,24,100  37230
-32,21,2400 -27,17,1100 -27,20,1150 -15,15,2350  0
-35,15,100 -30,16,100 -28,27,100 -14,15,208  36230
-31,24,189 -26,17,129 -29,14,100 -19,13,116  18170
-25,19,2200 -26,23,1300 -18,24,950 -25,12,1800  20280
-24,16,100 -25,24,100 -25,19,100 -27,13,100  20840
-28,27,196 -31,21,102 -13,30,190 -23,12,100  20960
-17,12,1550 -28,19,2650 -26,22,2000 -26,12,1350  0
-17,15,100 -31,17,100 -26,20,106 -20,16,100  45620
-19,12,100 -26,20,100 -24,24,100 -33,12,100  0
-16,20,900 -25,29,1550 -14,21,1300 -29,27,1100  0
-23,27,100 -24,30,101 -15,19,100 -36,22,100  0
-10,10,100 -30,30,100 -15,26,100 -24,36,118  0
-30,16,2050 -26,23,2150 -21,23,1800 -20,16,1500  46230
-34,12,138 -31,13,191 -10,22,100 -13,14,100  0
-26,25,100 -23,37,100 -29,25,108 -29,16,100  32160
-24,27,1050 -23,23,1600 -27,18,1450 -22,31,1600  0
-20,26,183 -24,29,100 -23,26,105 -36,34,164  0
-28,29,204 -21,19,100 -30,15,100 -13,29,100  33150
-24,22,2300 -21,26,1800 -24,21,1200 -23,16,2150  0
-14,32,100 -33,24,100 -22,20,154 -34,20,107  0
-34,11,110 -11,28,100 -28,20,100 -12,13,100  0
-23,20,1200 -16,28,1650 -23,24,1200 -15,14,2000  0
-32,13,100 -10,30,100 -26,21,100 -13,10,129  0
-12,29,100 -21,25,100 -19,28,100 -22,17,100  0
-15,28,750 -18,21,800 -20,19,800 -22,14,2500  0
-16,29,100 -21,27,109 -17,30,100 -19,15,149  0
-15,32,100 -16,17,100 -25,11,100 -22,11,100  0
-14,20,1900 -14,18,950 -27,17,800 -24,11,1950  0
-16,29,100 -17,15,200 -21,10,103 -24,11,111  0
-12,12,168 -12,23,157 -32,27,224 -22,14,100  0
-14,13,2400 -18,24,750 -23,26,1200 -17,19,1550  0
-12,13,100 -11,23,100 -33,26,100 -26,13,100  0
-14,14,100 -25,25,100 -18,26,132 -10,27,100  0
-16,13,1900 -28,27,400 -20,27,2150 -21,19,1300  0
-17,13,100 -23,25,100 -18,26,100 -11,28,100  0
-15,11,100 -33,27,100 -24,26,100 -33,10,100  0
-18,22,1500 -24,26,350 -29,20,1550 -26,11,650  0
-15,12,100 -34,28,100 -26,26,139 -34,14,188  0
-20,34,100 -15,25,100 -37,14,100 -22,10,100  0
