-32,16,100 -25,10,100 -30,35,100 -10,23,100  45610
-35,17,100 -29,16,100 -28,27,100 -15,13,100  38180
-15,17,198 -32,17,164 -28,22,100 -20,17,100  37860
-14,17,121 -12,17,100 -12,24,100 -10,26,100  35600
-30,22,100 -25,17,204 -30,15,100 -17,11,100  27860
-25,26,189 -21,36,100 -29,27,100 -27,14,100  27050
-23,21,101 -24,25,100 -18,25,100 -23,13,116  21750
-32,17,1925 -22,17,1650 -22,22,1750 -18,21,1275  0
-32,17,100 -25,22,143 -19,22,217 -19,17,113  0
-37,17,168 -17,12,100 -25,23,100 -18,27,100  0
-15,17,100 -22,17,100 -18,22,103 -15,20,100  0
-31,22,152 -25,17,100 -29,21,100 -13,22,154  0
-30,28,179 -22,17,100 -29,17,195 -13,30,186  0
-29,21,100 -23,23,100 -30,29,104 -19,19,100  0
-26,21,148 -28,22,101 -19,24,145 -25,12,100  0
-28,29,100 -30,20,131 -14,32,100 -22,10,100  0
-25,15,100 -26,23,100 -27,17,100 -25,12,100  0
-28,21,1194 -26,20,714 -23,19,525 -22,12,958  0
