-35,18,2200 -24,10,1500 -31,34,900 -10,23,1100  45670
-35,18,1400 -15,12,800 -15,10,2500 -22,31,1000  45670
-27,14,1200 -25,13,600 -18,23,2500 -25,30,2000  45650
-14,21,2400 -14,17,1200 -11,24,500 -12,25,600  40490
-33,16,2900 -29,15,100 -26,25,1400 -12,17,2600  36310
-32,26,1900 -26,19,2100 -28,15,900 -19,13,2100  33390
-24,14,3000 -23,25,2000 -24,17,1600 -27,12,2100  29890
-27,25,1400 -29,22,600 -12,31,300 -23,12,1500  21330
-16,15,1000 -29,18,2800 -28,18,2200 -21,14,1300  19690
-18,10,2100 -27,20,2500 -24,26,1800 -32,10,1400  0
-21,29,1300 -23,29,2200 -13,18,1700 -34,21,1900  0
-11,11,500 -28,29,900 -16,24,900 -25,34,300  0
-34,10,2500 -30,11,2000 -12,20,2700 -12,14,1900  0
-26,23,1600 -23,35,2300 -30,27,900 -29,18,1100  0
-21,27,600 -26,30,2200 -25,24,1100 -34,35,1700  0
-28,28,1500 -20,17,1000 -30,13,1800 -11,27,1500  0
-20,10,1800 -22,15,1300 -33,11,400 -16,14,2600  0
-14,28,3000 -24,32,2700 -21,21,2000 -11,14,2500  0
-14,27,300 -21,27,500 -18,29,600 -20,17,2400  0
-28,34,1500 -34,10,700 -25,15,1900 -15,12,1400  0
-20,35,800 -28,19,2600 -30,21,1600 -34,19,100  0
-16,15,2200 -24,26,700 -16,28,1800 -10,26,1800  0
-27,24,1400 -16,11,500 -15,18,1700 -28,31,200  0
-10,29,800 -15,13,3000 -35,32,1200 -24,12,800  0
-17,11,1600 -33,28,100 -24,26,2500 -33,12,800  0
-11,13,1900 -12,21,1100 -16,18,2100 -15,21,1200  0
-31,10,500 -24,35,2800 -16,20,2700 -35,10,2500  0
-32,34,600 -20,31,500 -29,14,700 -19,16,2600  0
-17,13,2500 -10,16,800 -11,33,1900 -30,20,2100  0
-16,13,2700 -16,11,2200 -26,32,1000 -13,12,3000  0
-35,32,900 -15,24,2100 -20,26,400 -27,21,2600  0
-22,11,2500 -19,11,1400 -19,22,900 -13,21,2000  0
-30,22,1900 -13,14,200 -15,13,1800 -20,30,2400  0
-11,33,1800 -20,10,1800 -34,20,2100 -29,24,1800  0
-17,33,1000 -26,11,400 -31,20,1800 -11,26,2800  0
-17,29,1000 -22,23,200 -12,12,300 -31,28,1500  0
-27,26,900 -27,27,1000 -24,12,1200 -33,13,200  0
-34,34,200 -23,33,1400 -14,32,2000 -17,24,1600  0
-12,11,2600 -13,22,800 -31,25,600 -24,12,1300  0
-16,31,2500 -32,23,800 -20,22,600 -35,21,2700  0
-14,14,700 -24,17,1700 -11,29,1700 -18,20,100  0
-17,30,1200 -15,15,1100 -23,10,1000 -24,11,2600  0
-20,21,2700 -35,29,1800 -16,22,1000 -34,22,1100  0
-19,33,1400 -16,24,600 -35,15,600 -20,11,500  0
-33,13,2100 -11,30,2800 -28,20,1800 -11,11,1600  0
-15,28,2200 -21,10,1700 -34,28,2500 -27,17,2600  0
-10,34,100 -22,20,300 -16,32,500 -11,21,2300  0
-17,33,200 -24,32,1000 -30,27,2800 -33,25,1300  0
-24,28,2900 -35,33,300 -28,10,100 -34,28,200  0
-31,11,1900 -18,19,1500 -16,23,600 -15,19,2500  0
