-26,19,1300 -28,25,305 -31,20,570 -21,22,875  0
-33,25,100 -27,33,100 -35,18,100 -16,18,100  39290
-23,17,100 -29,21,163 -28,21,100 -24,27,177  47070
-30,21,200 -25,27,551 -16,27,750 -17,19,1128  47040
-32,21,100 -21,38,100 -13,31,100 -14,25,100  0
-27,20,100 -26,21,100 -23,23,100 -22,14,100  56800
-21,18,675 -24,32,825 -18,24,350 -23,14,525  0
-26,22,100 -30,35,100 -15,39,100 -29,13,158  0
-15,16,129 -17,33,100 -24,10,100 -16,14,196  0
-21,18,650 -22,23,400 -14,27,1300 -21,20,1125  0
-18,19,100 -23,25,184 -17,22,100 -14,29,100  0
-27,21,100 -19,23,100 -13,34,100 -28,13,100  0
-26,18,1950 -25,23,775 -31,22,1700 -24,23,1200  48690
-32,22,113 -26,23,100 -33,21,100 -22,24,100  39940
-22,14,100 -27,22,100 -29,23,100 -26,22,100  0
-21,15,100 -27,29,100 -25,17,100 -22,26,100  56760
-15,18,131 -28,27,100 -23,12,100 -17,19,100  48300
-29,14,100 -27,31,170 -23,25,113 -29,31,100  0
